11111111
1E0C0P11
101X0101
11111111