1111111111111111111111111111111111
1E0001000000X00C000X0C0000X0000001
1010010100100000101001000000010101
1010010010101010001001000000010101
1P00000X0C00C0000000000000000000C1
1111111111111111111111111111111111