111111111111111111
101010011011C11111
100100000011011101
1011C1111011011101
101100111001011001
100100000011000011
101101110011001011
100100000010101011
101101000011000011
101101110011010111
1C1110011001000011
101100110011011111
101110010001000001
101000001011011001
101101100001000001
1C1110100011010P01
1011C0101001000001
101000110011010E11
1101110010111100C1
111111111111111111